{
  "width": 32,
  "height": 24,
  "grid": [
    2, 2, 2, 2, 2, 2, 2, 2, 2, 2, 2, 2, 2, 2, 3, 3, 2, 2, 2, 2, 2, 2, 2, 2, 2, 2, 2, 2, 2, 2, 2, 2,
    2, 0, 0, 0, 0, 0, 0, 0, 0, 0, 0, 1, 1, 1, 1, 1, 1, 1, 1, 0, 0, 0, 0, 0, 0, 4, 4, 0, 0, 0, 0, 2,
    2, 0, 4, 4, 0, 0, 0, 0, 0, 0, 1, 1, 1, 1, 1, 1, 1, 1, 1, 1, 0, 0, 0, 0, 4, 4, 4, 4, 0, 0, 0, 2,
    2, 0, 4, 4, 0, 0, 0, 0, 0, 1, 1, 1, 0, 0, 0, 0, 0, 0, 1, 1, 1, 0, 0, 0, 0, 4, 4, 0, 0, 0, 0, 2,
    2, 0, 0, 0, 0, 2, 2, 2, 2, 1, 0, 0, 0, 0, 0, 0, 0, 0, 0, 0, 1, 2, 2, 2, 2, 0, 0, 0, 0, 0, 0, 2,
    2, 0, 0, 0, 0, 2, 6, 6, 2, 1, 0, 0, 0, 1, 1, 1, 1, 0, 0, 0, 1, 2, 6, 6, 2, 0, 0, 0, 5, 5, 0, 2,
    2, 0, 0, 0, 0, 2, 6, 6, 1, 1, 0, 0, 1, 1, 1, 1, 1, 1, 0, 0, 1, 1, 6, 6, 2, 0, 0, 5, 5, 5, 0, 2,
    2, 0, 0, 0, 0, 2, 2, 2, 2, 1, 0, 0, 1, 1, 1, 1, 1, 1, 0, 0, 1, 2, 2, 2, 2, 0, 0, 5, 5, 5, 0, 2,
    2, 0, 0, 0, 0, 0, 0, 0, 1, 1, 0, 0, 1, 1, 1, 1, 1, 1, 0, 0, 1, 1, 0, 0, 0, 0, 0, 0, 5, 0, 0, 2,
    2, 0, 0, 0, 1, 1, 1, 1, 1, 1, 1, 1, 1, 1, 1, 1, 1, 1, 1, 1, 1, 1, 1, 1, 1, 1, 0, 0, 0, 0, 0, 2,
    2, 0, 0, 0, 1, 1, 1, 1, 1, 1, 1, 1, 1, 1, 1, 1, 1, 1, 1, 1, 1, 1, 1, 1, 1, 1, 0, 0, 0, 0, 0, 2,
    2, 0, 0, 0, 1, 1, 1, 1, 1, 1, 1, 1, 1, 1, 1, 1, 1, 1, 1, 1, 1, 1, 1, 1, 1, 1, 0, 0, 0, 0, 0, 2,
    2, 0, 0, 0, 0, 0, 0, 0, 1, 1, 0, 0, 1, 1, 1, 1, 1, 1, 0, 0, 1, 1, 0, 0, 0, 0, 0, 0, 0, 0, 0, 2,
    2, 0, 0, 0, 0, 2, 2, 2, 2, 1, 0, 0, 1, 1, 1, 1, 1, 1, 0, 0, 1, 2, 2, 2, 2, 0, 0, 0, 0, 0, 0, 2,
    2, 0, 0, 0, 0, 2, 6, 6, 2, 1, 0, 0, 0, 1, 1, 1, 1, 0, 0, 0, 1, 2, 6, 6, 2, 0, 0, 7, 7, 7, 0, 2,
    2, 0, 0, 0, 0, 2, 6, 6, 1, 1, 0, 0, 0, 0, 1, 1, 0, 0, 0, 0, 1, 1, 6, 6, 2, 0, 0, 7, 0, 7, 0, 2,
    2, 0, 0, 0, 0, 2, 2, 2, 2, 1, 0, 0, 0, 0, 1, 1, 0, 0, 0, 0, 1, 2, 2, 2, 2, 0, 0, 7, 0, 7, 0, 2,
    2, 0, 0, 0, 0, 0, 0, 0, 0, 1, 1, 0, 0, 0, 1, 1, 0, 0, 0, 1, 1, 0, 0, 0, 0, 0, 0, 7, 0, 7, 0, 2,
    2, 0, 4, 4, 0, 0, 0, 0, 0, 0, 1, 1, 1, 1, 1, 1, 1, 1, 1, 1, 0, 0, 0, 0, 0, 0, 0, 7, 7, 7, 0, 2,
    2, 0, 4, 4, 0, 0, 0, 0, 0, 0, 0, 1, 1, 1, 1, 1, 1, 1, 1, 0, 0, 0, 0, 4, 4, 0, 0, 0, 0, 0, 0, 2,
    2, 0, 0, 0, 0, 0, 0, 0, 0, 0, 0, 0, 1, 1, 1, 1, 1, 1, 0, 0, 0, 0, 4, 4, 4, 4, 0, 0, 0, 0, 0, 2,
    2, 0, 0, 0, 0, 0, 0, 0, 0, 0, 0, 0, 0, 0, 0, 0, 0, 0, 0, 0, 0, 0, 0, 4, 4, 0, 0, 0, 0, 0, 0, 2,
    2, 0, 0, 0, 0, 0, 0, 0, 0, 0, 0, 0, 0, 0, 0, 0, 0, 0, 0, 0, 0, 0, 0, 0, 0, 0, 0, 0, 0, 0, 0, 2,
    2, 2, 2, 2, 2, 2, 2, 2, 2, 2, 2, 2, 2, 2, 2, 2, 2, 2, 2, 2, 2, 2, 2, 2, 2, 2, 2, 2, 2, 2, 2, 2
  ]
}
